#PERMISSIVE
BEGIN 6 1
0,1,0,1,0,0,3
0,0,0,1,1,0,5
0,1,0,0,0,1,7
1,0,0,0,0,1,8
1,0,0,0,0,0,0
0,1,0,1,1,0,5
0,1,0,0,1,0,24

